SO ./textures/black_knight.xpm
WE ./textures/white_knight.xpm
NO ./textures/black_rook.xpm
EA ./textures/white_rook.xpm

F 38, 211, 177 
C  235, 88, 245 


       1                         1
    1110111         1         1110111
   100000001     1110111     100000001
  10000100001  11000000011  10000100001
 100011111000110000010000011000111110001
 1001     1001000111 1110001001     1001
 1001     1001001       1001001     1001
1001       10001         10001       1001
 1001     100001         100001     1001
 1001     100001    1    100001     1001
 100011 1100001 111101111 1000011 110001
  1000010000100100000000010010000100001
   10000000110000000000000001100000001
    111000000000000000000000000000111
    100000100000000000000000001000001
   1000111 1000000000000000001 1110001
   1001   100000000000000000001   1001
  1001    100000000000000000001    1001
  1001    100000000000000000001    1001
  1001    100000000000000000001    1001
 1001    10000000000N00000000001    1001
  1001    100000000000000000001    1001
  1001    100000000000000000001    1001
  1001    100000000000000000001    1001
   1001   100000000000000000001   1001
   1000111 1000000000000000001 1110001
    100000100000000000000000001000001
    111000000000000000000000000000111
   10000000110000000000000001100000001
  1000010000100100000000010010000100001
 100011 1100001 111101111 1000011 110001
 1001     100001    1    100001     1001
 1001     100001         100001     1001
1001       10001         10001       1001
 1001     1001001       1001001     1001
 1001     1001000111 1110001001     1001
 100011 1100011000001000001100011 110001
  10000100001  11000000011  10000100001
   100000001     1110111     100000001
    1110111         1         1110111
       1                         1
