
SO ./textures/cote_container.xpm


NO ./textures/cote_container.xpm 


WE                   ./textures/face_container.xpm 

EA          ./textures/face_container.xpm 


 
C 0, 0, 0
F 45, 37, 34

11111111111111111111111111111111111111111111111111111111111111111111
100000001111111111111100000000000000000000000111111100000000000000001
100000000000000000011100000000000000000000000000111000000000000000001
100001110000000000001100000000000000000000000001110000000000000000001
100001111000000000001100000000000000000000000000110000000000000000001
100000111110000001111100000000000000000000000000111000000000000000001
100000000000000000000000000000000000000000000000011100000000000000001
100000000000000000001110000000000000000000000000011110000000000000001
100000000000000000001111111111111111111111111111111100000000000000001
100001111100000000000000000000000000000000000000000000000000000000001
100000111110000000000011111111111111111111111111111110000000000000001
100000000000000000000000000000000000000000000000000011000000000000001
100000000000000000000000000000000000000000000000000001111000000000001
100000000000000000000000000000000000000000000000000000000111111000001
100000000111111111100000000000000000000000000000000000000000001111111
100000000111111111110000000000000000000000000000000000000000000000001
100000001111100000001111111000000000000000000000000000000000000000001
100000010000000000000011111000000000000000000000000000000000000000001
100000100000000000000000000100000000000000000111111111100000000000001
100000100000000000000000000010000000000000001000000000010000000000001
100000100000000000000000000001000000000000010000000000001000000000001
100000000000000000000000000000100000000000100000000000000100000000001
1000000100000000000W0000000000010000000001000000010100000010000000001
100000001000000000000000000000100000000010000000001000000001000000001
100000000100000000000000000001000000000010000000010100000001000000001
100000000010000000000000000010000000000001000000000000000010000000001
100000000001000000000000000100000000000000100000000000000100000000001
100000000000111111111111111000000000000000011111100011111000000000001
100000000000000000000000000000000000000000000000000000000000000000001
100000000000000000000000000000000000000000000000000000000000000000001
100001111111111111111100000000000000000000000000000000000000000000001
100000000111111111111100000000000000000000000000000000000000000000001
100000000000000011110000000000000000000000000000000000000000000000001
100000000000000001111100000000000000000000000000000000000000000000001
11111111111111111111111111111111111111111111111111111111111111111111
