
SO ./textures/brick.xpm
NO ./textures/metal.xpm 
WE ./textures/wood.xpm 
EA ./textures/stone.xpm 


 
C 5  1          , 243   , 255
F 20, 187      , 43
   
011111111111111111111111111111111111
100000000000000000000000000000000001
100011100000000111000000000111000001
100111110001011111100000011111111111
100001100000100111110000000000000001
100000000000000000000000000000001111
111111111000000000000000000000000001
100000000000000000000000000011100001
100000000000000000000000000000110001
100001111100000000111111000000000001
100000001110000000001111100000000001
100000000111000000000011111N11111111
100000000111000000000000000100000001
100000000111000000000000000100000001
100001111111000000000000000100000001
100001111111000000000111111111000001
100000000111000000000000111111111111
100000000111000000000000000001111001
100000000111000000000000000000000001
111111111111111111111111111111111111   
