
SO ./textures/brick.xpm
NO ./textures/metal.xpm 
WE ./textures/wood.xpm 
EA ./textures/stone.xpm 


 
C 51, 243, 255
F 20, 187, 43

11111111111111111111111111111111111111111111111111111111111111111111
1N100000000000000000000000000000000000000000000000000000000000000001
10101111111111111111111111111111111111111111111111111111111111111101
10100000000000000100000000000000000000000000000000000000000000000101
10111111111111110101111111111111111111111111111111111111111111110101
10100000000000000100000000010000000000000000000000000000000000010101
10100111111111111111111111011111111111111110111111111111111110010101
10100100010001000100000000010000000000000010000000000000000001010101
10100101010101010101111111110111111111111111111111111111111001010101
10100001000100010100000000010000000000000010000000000000000001010101
10111111111111110111111011111111110111111111101110101011111101010101
10100000000000000000000000000000000000000000100000101000000101010101
10100011111111111111111111111111111111111110111110101011111101010101
10100010000000000000000000000000000000000010100010101000000000010101
10100010000000001111111111111111111111111010101010101111111111110101
10100011111111101000000000000000000000001010101010100000000000010101
10111010001010001011111111111111111111101010101010101111111111010101
10100000100010111010000000000000000000101010101010000000000001010101
10101111111010100011111111111111111100101010101110111111111001010101
10100010001010100000000000000000000000101010100110100000000001010101
101010101010101111111111111111111111111010101101101011111111110101011111111111111
100010001000100000000000000000000000000010000000001000000000010101000000000000001
111111111111111111111111111111111111111111111111111111111111111111111111111111111
