
SO            ./textures/brick.xpm
NO           ./textures/metal.xpm 

WE ./textures/wood.xpm 


EA               ./textures/stone.xpm 


 
C 51           ,           243, 255

F 20  , 187                    ,       43
   
011111111111111111111111111111111
100000000111111000000000000000000111
 111100011100000000111000000000111011101
    11111111100111110001011111100000011111111111
         1000011000001001111100000000001111
111111111000000000000000000000000111111111
111111111000000000000000000000000001000
10000000000000000000000000001110000111
 111111100000000000000000000000000000110001
100001111100000000111111000000000011101
100000001110000000001111100000000001
100000000111000000000011111N11111111
1111000000111000000000000000100000001
    11111100000000111000000000000000100000001
11110000000111100000000000000010000110
100001111111000000000111111111000001
100000000111000000000000111111111111111111111111
1000000001110000000000000000011110000000000000001
111000000111000000000000000000000001111111111101
   111111111111110000000111111111111111      101
    11111111111111111111111111111111         101
                                             101
                                             101
                                             101
                                             111
