
SO            ./textures/brick.xpm
NO           ./textures/metal.xpm 

WE ./textures/wood.xpm 


EA               ./textures/stone.xpm 


 
C 51           ,           243, 255

F 20  , 187                    ,       43
   
011111111111111111111111111111111111111111111111
10000000011111100000000000000000000000000000111
 1111000111000000001110000000001111011110000001111
    11111111100111110001011111100000000000000000011111111111
         10000110000010011111000000000000000001111
         10000110000010011111000000000000001111
         10000110000010011111000000000000001111
         10000110000010011111000000000000000001111
         100001100000100111110000000000000000001111
         100001100000100111110000000000000000001111
         100001100000100111110000000000000001111
         10000110000010011111000000000000001111
11111111100000000000000000000000110111111111
111111111000000000000000000000000001000
10000000000000000000000000001110000111111111
 111111100000000000000000000000000000000000110001
100001111100000000111111000000000011111111101
10000000111000000000111110000000000000000001
10000000011100000000000011111N111111111111111
1111000000111000000000000000010000000000001
    1111110000000011100000001000000000000100000001
11110000000011110000000000000011000000000110
1000011111110000000001111111110000000000001
100000000111000000000000111111111111111111111111
1000000001110000000000000000011110000000000000001
111000000111000000000000000000000001111111111101
   111111111111110000000111111111111111      101
    11111111111111111111111111111111         101
                                             101
                                             101
                                             101
                                             111
