SO ./textures/blue_nebula.xpm
WE ./textures/blue_nebula.xpm
NO ./textures/blue_nebula.xpm
EA ./textures/blue_nebula.xpm

F         11, 51, 79 
C     11, 51, 79 
11111111111111111111111111111111111111111
10000000000011110000000001111000000000001
10111111111011110000000001111011111111101
10111111111011110000000001111011111111101
10111111111011110000000001111011111111101
10111000000000000000000000000000000011101
10111011111011111111111111111011111011101
10111011111011111111111111111011111011101
10111011111011111111111111111011111011101
10111011111011111111111111111011111011101
10111011110000000000000000000001111011101
10000000000000000000000000000000000000001
11111011110000000000000000000001111011111
11111011110000000000000000000001111011111
11111011110000000000000000000001111011111
11111011110000000000000000000001111011111
11111011110000000000000000000001111011111
11111011110000000000000000000001111011111
10000000000000000000S00000000000000000001
10111011110000000000000000000001111011101
10111011110000000000000000000001111011101
10111011110000000000000000000001111011101
10000000000000000000000000000000000000001
11111011110000000000000000000001111011111
11111011110000000000000000000001111011111
11111011110000000000000000000001111011111
11111011110000000000000000000001111011111
11111011110000000000000000000001111011111
11111011110000000000000000000001111011111
10000000000000000000000000000000000000001
10111011110000000000000000000001111011101
10111011111011111111111111111011111011101
10111011111011111111111111111011111011101
10111011111011111111111111111011111011101
10111011111011111111111111111011111011101
10111000000000000000000000000000000011101
10111111111011111111111111111011111111101
10111111111011111111111111111011111111101
10111111111011111111111111111011111111101
10000000000011111111111111111000000000001
10000000000011110000000001111000000000001
10111111111011110000000001111011111111101
10111111111011110000000001111011111111101
10111111111011110000000001111011111111101
10111000000000000000000000000000000011101
10111011111011111111111111111011111011101
10111011111011111111111111111011111011101
10111011111011111111111111111011111011101
10111011111011111111111111111011111011101
10111011110000000000000000000001111011101
10000000000000000000000000000000000000001
11111011110000000000000000000001111011111
11111011110000000000000000000001111011111
11111011110000000000000000000001111011111
11111011110000000000000000000001111011111
11111011110000000000000000000001111011111
11111011110000000000000000000001111011111
10000000000000000000000000000000000000001
10111011110000000000000000000001111011101
10111011110000000000000000000001111011101
10111011110000000000000000000001111011101
10000000000000000000000000000000000000001
11111011110000000000000000000001111011111
11111011110000000000000000000001111011111
11111011110000000000000000000001111011111
11111011110000000000000000000001111011111
11111011110000000000000000000001111011111
11111011110000000000000000000001111011111
10000000000000000000000000000000000000001
10111011110000000000000000000001111011101
10111011111011111111111111111011111011101
10111011111011111111111111111011111011101
10111011111011111111111111111011111011101
10111011111011111111111111111011111011101
10111000000000000000000000000000000011101
10111111111011111111111111111011111111101
10111111111011111111111111111011111111101
10111111111011111111111111111011111111101
10000000000011111111111111111000000000001
11111111111111111111111111111111111111111
